1111111111111111111111111
1E00001000100000000110001
11101010101011111101111N1
10001000101C1011000000001
1010111011101011011111101
10101010000C000C010000001
101C101000100000000100101
101010101011101101N111101
10N00010101000000101000P1
1111111111111111111111111