11111111111111111111111111
10C000001E1000001000000001
100001000C000011100C011111
111101000C0C00001000000001
1C0001000000000000000000P1
11111111111111111111111111