1111111111111111111111111111111111
100000000000000000N000000000000001
10P00000000000000N00000000C0000001
1000000000000000N00000000000000001
1000110111010101101011101110110001
1000100101010101001010101010100001
100011C101010101101011101010110001
1000010101010101001010101010100001
1000110111011101001010101010110001
1000000000000000000000000000000001
10E0000000000000000C000000NNNNNNN1
1000000111000000000000000000000001
1111111111111111111111111111111111